





WE ./assets/images/north.xpm                          

      NO             ./assets/images/north.xpm
SO ./assets/images/north.xpm     
EA        ./assets/images/north.xpm
            F         51,51,51

C    0,191,255

   11
111N111111
10000000001
10000000001
10000100001
10000000001
10000000001
11111111111
