





WE ./assets/images/west.xpm                          

      NO             ./assets/images/north.xpm
SO ./assets/images/south.xpm     
EA        ./assets/images/east.xpm
            F         51,51,51

C    0,191,255

11111111111111111111111111111111111111111111111111111111
100001000000000000000000000000000100000100000000000000001
11000100000000000000000000000100000000100000000000010001
1000000000100000000000000S000000010001111100000000000001
100001000000000000000000000001000000000100000000000000001       
10000100000000000000000000001001000010110000000100000001
10000100000001111000000000000100000000000000000000000001
10000000000001  10000000000001000000000000000000000010001         
10000000000001  10000000100001000010000000000000000000001        
10000000000001  10000000000000000000010000001111111011111
10000000000001  10100100000001000000000100001     101
10001100000001  10000100000000000000000100001     101
10000000001001  10000100100000000001000100001     101
10000000000001  10000100001111110000000100001     101
10000000000001  10000100000000000000000000001     101
100001000000011110000010000000000010000000001     101
100000000000000000000000000000000000000000001     101
100000000001111100000000000000000000000000001     101
100010000000000000000000000000000100000000001   1110111111
100000000000000000000000000000011111111000001   10000000001
10000000000001000000000000000001      1000001   10000000001
100000000000000000100000000000011111111000001   10000100001
100000000000000000100000000000000100000000001   10000000001
100000000000000000100000000000000100000000001   10000000001
100000000000010000100010000000000000000000001   11111111111
100000000000000000100000000000000001000000001
100000010000000000000000000000000000000000001
100000000000000000000000000000000000000000001
11111111111111111111111111111111111111111111
11111111111111111111111111111111111111111111111111111111
100001000000000000000000000000000100000100000000000000001
11000100000000000000000000000100000000100000000000010001
10000000001000000000000000000000010001111100000000000001
100001000000000000000000000001000000000100000000000000001       
10000100000000000000000000001001000010110000000100000001
10000100000001111000000000000100000000000000000000000001
10000000000001  10000000000001000000000000000000000010001         
10000000000001  10000000100001000010000000000000000000001        
10000000000001  10000000000000000000010000001111111011111
10000000000001  10100100000001000000000100001     101
10001100000001  10000100000000000000000100001     101
10000000001001  10000100100000000001000100001     101
10000000000001  10000100001111110000000100001     101
10000000000001  10000100000000000000000000001     101
100001000000011110000010000000000010000000001     101
100000000000000000000000000000000000000000001     101
100000000001111100000000000000000000000000001     101
100010000000000000000000000000000100000000001   1110111111
100000000000000000000000000000011111111000001   10000000001
10000000000001000000000000000001      1000001   10000000001
100000000000000000100000000000011111111000001   10000100001
100000000000000000100000000000000100000000001   10000000001
100000000000000000100000000000000100000000001   10000000001
100000000000010000100010000000000000000000001   11111111111
100000000000000000100000000000000001000000001
100000010000000000000000000000000000000000001
100000000000000000000000000000000000000000001
1111111111111111111111111111111111111111111111111111111111111111111111111111111111111111111111111111
100001000000000000000000000000000100000100000000000000001
11000100000000000000000000000100000000100000000000010001
10000000001000000000000000000000010001111100000000000001
100001000000000000000000000001000000000100000000000000001       
10000100000000000000000000001001000010110000000100000001
10000100000001111000000000000100000000000000000000000001
10000000000001  10000000000001000000000000000000000010001         
10000000000001  10000000100001000010000000000000000000001        
10000000000001  10000000000000000000010000001111111011111
10000000000001  10100100000001000000000100001     101
10001100000001  10000100000000000000000100001     101
10000000001001  10000100100000000001000100001     101
10000000000001  10000100001111110000000100001     101
10000000000001  10000100000000000000000000001     101
100001000000011110000010000000000010000000001     101
100000000000000000000000000000000000000000001     101
100000000001111100000000000000000000000000001     101
100010000000000000000000000000000100000000001   1110111111
100000000000000000000000000000011111111000001   10000000001
10000000000001000000000000000001      1000001   10000000001
100000000000000000100000000000011111111000001   10000100001
100000000000000000100000000000000100000000001   10000000001
100000000000000000100000000000000100000000001   10000000001
100000000000010000100010000000000000000000001   11111111111
100000000000000000100000000000000001000000001
100000010000000000000000000000000000000000001
100000000000000000000000000000000000000000001
11111111111111111111111111111111111111111111
